stabilimetre	stabilimetre	Nom:Mas+SG
stabilisaient	stabiliser	Ver:IImp+PL+P3
stabilisais	stabiliser	Ver:IImp+SG+P1:IImp+SG+P2
stabilisai	stabiliser	Ver:IPSim+SG+P1
stabilisait	stabiliser	Ver:IImp+SG+P3
stabilisames	stabiliser	Ver:IPSim+PL+P1
stabilisant	stabilisant	Adj:Mas+SG
stabilisant	stabilisant	Nom:Mas+SG
stabilisant	stabiliser	Ver:PPre
stabilisassent	stabiliser	Ver:SImp+PL+P3
percevaient	percevoir	Ver:IImp+PL+P3
percevoir	percevoir	Ver:Inf
zozotant	zozoter	Ver:PPre
zoopsie	zoopsie	Nom:Fem+SG
zoosemiotique	zoosemiotique	Adj:InvGen+SG
zoosemiotique	zoosemiotique	Nom:Fem+SG
zoosporange	zoosporange	Nom:Mas+SG
zoospore	zoospore	Nom:Fem+SG
zoos	zoo	Nom:Mas+PL
zootaxie	zootaxie	Nom:Fem+SG
zootechniciennes	zootechnicien	Nom:Fem+PL
zootechnicienne	zootechnicien	Nom:Fem+SG
zootechnicien	zootechnicien	Nom:Mas+SG
zootechnie	zootechnie	Nom:Fem+SG
zootechnique	zootechnique	Adj:InvGen+SG
zootherapeutique	zootherapeutique	Adj:InvGen+SG
zootherapie	zootherapie	Nom:Fem+SG
zoo	zoo	Nom:Mas+SG
zorille	zorille	Nom:Fem+SG
zoroastriennes	zoroastrien	Adj:Fem+PL
zoroastriennes	zoroastrien	Nom:Fem+PL
zoroastrienne	zoroastrien	Adj:Fem+SG
zoroastrienne	zoroastrien	Nom:Fem+SG
zoroastriens	zoroastrien	Adj:Mas+PL
zoroastriens	zoroastrien	Nom:Mas+PL
zoroastrien	zoroastrien	Adj:Mas+SG
zoroastrismes	zoroastrisme	Nom:Mas+PL
zoroastrisme	zoroastrisme	Nom:Mas+SG
zostere	zostere	Nom:Fem+SG
zosteriennes	zosterien	Adj:Fem+PL
zosterienne	zosterien	Adj:Fem+SG
zosterien	zosterien	Adj:Mas+SG
zouaves	zouave	Nom:Mas+PL
zouave	zouave	Nom:Mas+SG
zou	zou	Int
zozote	zozoter	Ver:PPas+Mas+SG
zozo	zozo	Nom:Mas+SG
zucchette	zucchette	Nom:Fem+SG
zuchette	zuchette	Nom:Fem+SG
zurichois	zurichois	Adj:Mas+PL
zurichois	zurichois	Adj:Mas+SG
zutique	zutique	Adj:InvGen+SG
zutiste	zutiste	Nom:InvGen+SG
zut	zut	Int
zwanze	zwanze	Nom:InvGen+SG
zwinglianisme	zwinglianisme	Nom:Mas+SG
zwingliennes	zwinglien	Adj:Fem+PL
zwinglienne	zwinglien	Adj:Fem+SG
zwinglien	zwinglien	Adj:Mas+SG
zyeuter	zyeuter	Ver:Inf
zygene	zygene	Nom:Fem+SG
zygomatiques	zygomatique	Adj:InvGen+PL
zygomatiques	zygomatique	Nom:Mas+PL
zygomatique	zygomatique	Adj:InvGen+SG
zygomatique	zygomatique	Nom:Mas+SG
zygoma	zygoma	Nom:Mas+SG
zygomorphe	zygomorphe	Adj:InvGen+SG
zygomycetes	zygomycete	Nom:Mas+PL
zygomycete	zygomycete	Nom:Mas+SG
zygopetale	zygopetale	Nom:Mas+SG
zygote	zygote	Nom:Mas+SG
zymase	zymase	Nom:Fem+SG
zymotechnie	zymotechnie	Nom:Fem+SG
zymotique	zymotique	Adj:InvGen+SG
percerons	percer	Ver:IFut+PL+P1
perceront	percer	Ver:IFut+PL+P3
percer	percer	Ver:Inf
perces	perce	Nom:Fem+PL
perces	percer	Ver:IPre+SG+P2:SPre+SG+P2
perces	percer	Ver:PPas+Mas+PL
perceur	perceur	Adj:Mas+SG
perceurs	perceur	Adj:Mas+PL
perceuse	perceur	Adj:Fem+SG
perceuse	perceur	Nom:Fem+SG
perceuse	perceuse	Nom:Fem+SG
perceuses	perceur	Adj:Fem+PL
perceuses	perceur	Nom:Fem+PL
perceuses	perceuse	Nom:Fem+PL
percevable	percevable	Adj:InvGen+SG
percevables	percevable	Adj:InvGen+PL
percevais	percevoir	Ver:IImp+SG+P1:IImp+SG+P2
percevait	percevoir	Ver:IImp+SG+P3
percevant	percevoir	Ver:PPre
percevez	percevoir	Ver:IPre+PL+P2:ImPre+PL+P2
perceviez	percevoir	Ver:IImp+PL+P2:SPre+PL+P2
percevions	percevoir	Ver:IImp+PL+P1:SPre+PL+P1
percevoir	percevoir	Ver:Inf
percevons	percevoir	Ver:IPre+PL+P1:ImPre+PL+P1
percevraient	percevoir	Ver:CPre+PL+P3
percevrai	percevoir	Ver:IFut+SG+P1
percevrais	percevoir	Ver:CPre+SG+P1:CPre+SG+P2
percevrait	percevoir	Ver:CPre+SG+P3
percevra	percevoir	Ver:IFut+SG+P3
percevras	percevoir	Ver:IFut+SG+P2
percevrez	percevoir	Ver:IFut+PL+P2
percevriez	percevoir	Ver:CPre+PL+P2
percevrions	percevoir	Ver:CPre+PL+P1
percevrons	percevoir	Ver:IFut+PL+P1
percevront	percevoir	Ver:IFut+PL+P3
zozoter	zozoter	Ver:Inf
percez	percer	Ver:IPre+PL+P2:ImPre+PL+P2